1111
1001
1111
1E11
1001
1CC1
10P1
1111
